2 11 11 11 11 11 11 11 11 11 11 11 11 36 35 11 11 11 11 11 11 11 11 11 11 11 11 1
4 37 37 37 37 37 37 37 37 37 37 37 37 22 21 37 37 37 37 37 37 37 37 37 37 37 37 3
4 37 20 13 13 19 37 20 13 13 13 19 37 22 21 37 20 13 13 13 19 37 20 13 13 19 37 3
4 38 22 0 0 21 37 22 0 0 0 21 37 22 21 37 22 0 0 0 21 37 22 0 0 21 38 3
4 37 24 18 18 23 37 24 18 18 18 23 37 24 23 37 24 18 18 18 23 37 24 18 18 23 37 3
4 37 37 37 37 37 37 37 37 37 37 37 37 37 37 37 37 37 37 37 37 37 37 37 37 37 37 3
4 37 20 13 13 19 37 20 19 37 20 13 13 13 13 13 13 19 37 20 19 37 20 13 13 19 37 3
4 37 24 18 18 23 37 22 21 37 24 18 18 19 20 18 18 23 37 22 21 37 24 18 18 23 37 3
4 37 37 37 37 37 37 22 21 37 37 37 37 21 22 37 37 37 37 22 21 37 37 37 37 37 37 3
6 12 12 12 12 19 37 22 33 13 13 19 0 21 22 0 20 13 13 34 21 37 20 12 12 12 12 5
0 0 0 0 0 4 37 22 31 18 18 23 0 33 34 0 24 18 18 32 21 37 3 0 0 0 0 0
0 0 0 0 0 4 37 22 21 0 0 0 0 0 0 0 0 0 0 22 21 37 3 0 0 0 0 0
0 0 0 0 0 4 37 22 21 0 26 12 30 39 39 29 12 25 0 22 21 37 3 0 0 0 0 0
11 11 11 11 11 23 37 24 23 0 3 0 0 0 0 0 0 4 0 24 23 37 24 11 11 11 11 11
0 0 0 0 0 0 37 0 0 0 3 0 0 0 0 0 0 4 0 0 0 37 0 0 0 0 0 0
12 12 12 12 12 19 37 20 19 0 3 0 0 0 0 0 0 4 0 20 19 37 20 12 12 12 12 12
0 0 0 0 0 4 37 22 21 0 28 11 11 11 11 11 11 27 0 22 21 37 3 0 0 0 0 0
0 0 0 0 0 4 37 22 21 0 0 0 0 0 0 0 0 0 0 22 21 37 3 0 0 0 0 0
0 0 0 0 0 4 37 22 21 0 20 13 13 13 13 13 13 19 0 22 21 37 3 0 0 0 0 0
2 11 11 11 11 23 37 24 23 0 24 18 18 32 31 18 18 23 0 24 23 37 24 11 11 11 11 1
4 37 37 37 37 37 37 37 37 37 37 37 37 22 21 37 37 37 37 37 37 37 37 37 37 37 37 3
4 37 20 13 13 19 37 20 13 13 13 19 37 22 21 37 20 13 13 13 19 37 20 13 13 19 37 3
4 37 24 18 32 21 37 24 18 18 18 23 37 24 23 37 24 18 18 18 23 37 22 31 18 23 37 3
4 38 37 37 22 21 37 37 37 37 37 37 37 0 0 37 37 37 37 37 37 37 22 21 37 37 38 3
8 13 19 37 22 21 37 20 19 37 20 13 13 13 13 13 13 19 37 20 19 37 22 21 37 20 13 7
10 18 23 37 24 23 37 22 21 37 24 18 18 32 31 18 18 23 37 22 21 37 24 23 37 24 18 9
4 37 37 37 37 37 37 22 21 37 37 37 37 22 21 37 37 37 37 22 21 37 37 37 37 37 37 3
4 37 20 13 13 13 13 34 33 13 13 19 37 22 21 37 20 13 13 34 33 13 13 13 13 19 37 3
4 37 24 18 18 18 18 18 18 18 18 23 37 24 23 37 24 18 18 18 18 18 18 18 18 23 37 3
4 37 37 37 37 37 37 37 37 37 37 37 37 37 37 37 37 37 37 37 37 37 37 37 37 37 37 3
6 12 12 12 12 12 12 12 12 12 12 12 12 12 12 12 12 12 12 12 12 12 12 12 12 12 12 5

0 0 0 0 0 0 0 0 0 0 0 0 0 0 0 0 0 0 0 0 0 0 0 0 0 0 0 0
0 0 0 0 0 0 0 0 0 0 0 0 0 0 0 0 0 0 0 0 0 0 0 0 0 0 0 0
0 0 0 0 0 0 0 0 0 0 0 0 0 0 0 0 0 0 0 0 0 0 0 0 0 0 0 0
0 0 0 0 0 0 0 0 0 0 0 0 0 0 0 0 0 0 0 0 0 0 0 0 0 0 0 0
0 0 0 0 0 0 0 0 0 0 0 0 0 0 0 0 0 0 0 0 0 0 0 0 0 0 0 0
0 0 0 0 0 0 0 0 0 0 0 0 0 0 0 0 0 0 0 0 0 0 0 0 0 0 0 0
0 0 0 0 0 0 0 0 0 0 0 0 0 0 0 0 0 0 0 0 0 0 0 0 0 0 0 0
0 0 0 0 0 0 0 0 0 0 0 0 0 0 0 0 0 0 0 0 0 0 0 0 0 0 0 0
0 0 0 0 0 0 0 0 0 0 0 0 0 0 0 0 0 0 0 0 0 0 0 0 0 0 0 0
0 0 0 0 0 0 0 0 0 0 0 0 0 0 0 0 0 0 0 0 0 0 0 0 0 0 0 0
0 0 0 0 0 0 0 0 0 0 0 0 0 0 0 0 0 0 0 0 0 0 0 0 0 0 0 0
0 0 0 0 0 0 0 0 0 0 0 0 0 0 2 0 0 0 0 0 0 0 0 0 0 0 0 0
0 0 0 0 0 0 0 0 0 0 0 0 0 0 0 0 0 0 0 0 0 0 0 0 0 0 0 0
0 0 0 0 0 0 0 0 0 0 0 10 10 10 10 10 10 0 0 0 0 0 0 0 0 0 0 0
8 8 8 8 8 0 0 0 0 0 0 10 5 9 3 4 10 0 0 0 0 0 0 8 8 8 8 8
0 0 0 0 0 0 0 0 0 0 0 10 10 10 10 10 10 0 0 0 0 0 0 0 0 0 0 0
0 0 0 0 0 0 0 0 0 0 0 0 0 0 0 0 0 0 0 0 0 0 0 0 0 0 0 0
0 0 0 0 0 0 0 0 0 0 0 0 0 0 0 0 0 0 0 0 0 0 0 0 0 0 0 0
0 0 0 0 0 0 0 0 0 0 0 0 0 0 0 0 0 0 0 0 0 0 0 0 0 0 0 0
0 0 0 0 0 0 0 0 0 0 0 0 0 0 0 0 0 0 0 0 0 0 0 0 0 0 0 0
0 0 0 0 0 0 0 0 0 0 0 0 0 0 0 0 0 0 0 0 0 0 0 0 0 0 0 0
0 0 0 0 0 0 0 0 0 0 0 0 0 0 0 0 0 0 0 0 0 0 0 0 0 0 0 0
0 0 0 0 0 0 0 0 0 0 0 0 0 0 0 0 0 0 0 0 0 0 0 0 0 0 0 0
0 0 0 0 0 0 0 0 0 0 0 0 0 0 1 0 0 0 0 0 0 0 0 0 0 0 0 0
0 0 0 0 0 0 0 0 0 0 0 0 0 0 0 0 0 0 0 0 0 0 0 0 0 0 0 0
0 0 0 0 0 0 0 0 0 0 0 0 0 0 0 0 0 0 0 0 0 0 0 0 0 0 0 0
0 0 0 0 0 0 0 0 0 0 0 0 0 0 0 0 0 0 0 0 0 0 0 0 0 0 0 0
0 0 0 0 0 0 0 0 0 0 0 0 0 0 0 0 0 0 0 0 0 0 0 0 0 0 0 0
0 0 0 0 0 0 0 0 0 0 0 0 0 0 0 0 0 0 0 0 0 0 0 0 0 0 0 0
0 0 0 0 0 0 0 0 0 0 0 0 0 0 0 0 0 0 0 0 0 0 0 0 0 0 0 0
0 0 0 0 0 0 0 0 0 0 0 0 0 0 0 0 0 0 0 0 0 0 0 0 0 0 0 0
