28 31

 +0x001 +0x002 +0x002 +0x002 +0x002 +0x002 +0x002 +0x002 +0x002 +0x002 +0x002 +0x002 +0x002 +0x003 +0x004 +0x002 +0x002 +0x002 +0x002 +0x002 +0x002 +0x002 +0x002 +0x002 +0x002 +0x002 +0x002 +0x005
 +0x006 +0x025 +0x025 +0x025 +0x025 +0x025 +0x025 +0x025 +0x025 +0x025 +0x025 +0x025 +0x025 +0x008 +0x009 +0x025 +0x025 +0x025 +0x025 +0x025 +0x025 +0x025 +0x025 +0x025 +0x025 +0x025 +0x025 +0x006
 +0x006 +0x025 +0x010 +0x00E +0x00E +0x00F +0x025 +0x010 +0x00E +0x00E +0x00E +0x00F +0x025 +0x008 +0x009 +0x025 +0x010 +0x00E +0x00E +0x00E +0x00F +0x025 +0x010 +0x00E +0x00E +0x00F +0x025 +0x006
 +0x006 +0x026 +0x008 +0x000 +0x000 +0x009 +0x025 +0x008 +0x000 +0x000 +0x000 +0x009 +0x025 +0x008 +0x009 +0x025 +0x008 +0x000 +0x000 +0x000 +0x009 +0x025 +0x008 +0x000 +0x000 +0x009 +0x026 +0x006
 +0x006 +0x025 +0x015 +0x013 +0x013 +0x014 +0x025 +0x015 +0x013 +0x013 +0x013 +0x014 +0x025 +0x00B +0x00A +0x025 +0x015 +0x013 +0x013 +0x013 +0x014 +0x025 +0x015 +0x013 +0x013 +0x014 +0x025 +0x006
 +0x006 +0x025 +0x025 +0x025 +0x025 +0x025 +0x025 +0x025 +0x025 +0x025 +0x025 +0x025 +0x025 +0x025 +0x025 +0x025 +0x025 +0x025 +0x025 +0x025 +0x025 +0x025 +0x025 +0x025 +0x025 +0x025 +0x025 +0x006
 +0x006 +0x025 +0x010 +0x00E +0x00E +0x00F +0x025 +0x010 +0x00F +0x025 +0x010 +0x00E +0x00E +0x00E +0x00E +0x00E +0x00E +0x00F +0x025 +0x010 +0x00F +0x025 +0x010 +0x00E +0x00E +0x00F +0x025 +0x006
 +0x006 +0x025 +0x015 +0x013 +0x013 +0x014 +0x025 +0x008 +0x009 +0x025 +0x015 +0x013 +0x013 +0x023 +0x022 +0x013 +0x013 +0x014 +0x025 +0x008 +0x009 +0x025 +0x015 +0x013 +0x013 +0x014 +0x025 +0x006
 +0x006 +0x025 +0x025 +0x025 +0x025 +0x025 +0x025 +0x008 +0x009 +0x025 +0x025 +0x025 +0x025 +0x008 +0x009 +0x025 +0x025 +0x025 +0x025 +0x008 +0x009 +0x025 +0x025 +0x025 +0x025 +0x025 +0x025 +0x006
 +0x007 +0x002 +0x002 +0x002 +0x002 +0x005 +0x025 +0x008 +0x024 +0x00E +0x00E +0x00F +0x000 +0x008 +0x009 +0x000 +0x010 +0x00E +0x00E +0x021 +0x009 +0x025 +0x001 +0x002 +0x002 +0x002 +0x002 +0x00C
 +0x000 +0x000 +0x000 +0x000 +0x000 +0x006 +0x025 +0x008 +0x022 +0x013 +0x013 +0x014 +0x000 +0x015 +0x014 +0x000 +0x015 +0x013 +0x013 +0x023 +0x009 +0x025 +0x006 +0x000 +0x000 +0x000 +0x000 +0x000
 +0x000 +0x000 +0x000 +0x000 +0x000 +0x006 +0x025 +0x008 +0x009 +0x000 +0x000 +0x000 +0x000 +0x000 +0x000 +0x000 +0x000 +0x000 +0x000 +0x008 +0x009 +0x025 +0x006 +0x000 +0x000 +0x000 +0x000 +0x000
 +0x000 +0x000 +0x000 +0x000 +0x000 +0x006 +0x025 +0x008 +0x009 +0x000 +0x01A +0x018 +0x019 +0x01F +0x01F +0x017 +0x018 +0x01B +0x000 +0x008 +0x009 +0x025 +0x006 +0x000 +0x000 +0x000 +0x000 +0x000
 +0x002 +0x002 +0x002 +0x002 +0x002 +0x00C +0x025 +0x015 +0x014 +0x000 +0x01C +0x000 +0x000 +0x000 +0x000 +0x000 +0x000 +0x01D +0x000 +0x015 +0x014 +0x025 +0x007 +0x002 +0x002 +0x002 +0x002 +0x002
 +0x025 +0x025 +0x025 +0x025 +0x025 +0x025 +0x025 +0x000 +0x000 +0x000 +0x01C +0x000 +0x000 +0x000 +0x000 +0x000 +0x000 +0x01D +0x000 +0x000 +0x000 +0x025 +0x025 +0x025 +0x025 +0x025 +0x025 +0x025
 +0x002 +0x002 +0x002 +0x002 +0x002 +0x005 +0x025 +0x010 +0x00F +0x000 +0x01C +0x000 +0x000 +0x000 +0x000 +0x000 +0x000 +0x01D +0x000 +0x010 +0x00F +0x025 +0x001 +0x002 +0x002 +0x002 +0x002 +0x002
 +0x000 +0x000 +0x000 +0x000 +0x000 +0x006 +0x025 +0x008 +0x009 +0x000 +0x01E +0x01F +0x01F +0x01F +0x01F +0x01F +0x01F +0x020 +0x000 +0x008 +0x009 +0x025 +0x006 +0x000 +0x000 +0x000 +0x000 +0x000
 +0x000 +0x000 +0x000 +0x000 +0x000 +0x006 +0x025 +0x008 +0x009 +0x000 +0x000 +0x000 +0x000 +0x000 +0x000 +0x000 +0x000 +0x000 +0x000 +0x008 +0x009 +0x025 +0x006 +0x000 +0x000 +0x000 +0x000 +0x000
 +0x000 +0x000 +0x000 +0x000 +0x000 +0x006 +0x025 +0x008 +0x009 +0x000 +0x010 +0x00E +0x00E +0x00E +0x00E +0x00E +0x00E +0x00F +0x000 +0x008 +0x009 +0x025 +0x006 +0x000 +0x000 +0x000 +0x000 +0x000
 +0x001 +0x002 +0x002 +0x002 +0x002 +0x00C +0x025 +0x015 +0x014 +0x000 +0x015 +0x013 +0x013 +0x023 +0x022 +0x013 +0x013 +0x014 +0x000 +0x015 +0x014 +0x025 +0x007 +0x002 +0x002 +0x002 +0x002 +0x005
 +0x006 +0x025 +0x025 +0x025 +0x025 +0x025 +0x025 +0x025 +0x025 +0x025 +0x025 +0x025 +0x025 +0x008 +0x009 +0x025 +0x025 +0x025 +0x025 +0x025 +0x025 +0x025 +0x025 +0x025 +0x025 +0x025 +0x025 +0x006
 +0x006 +0x025 +0x010 +0x00E +0x00E +0x00F +0x025 +0x010 +0x00E +0x00E +0x00E +0x00F +0x025 +0x008 +0x009 +0x025 +0x010 +0x00E +0x00E +0x00E +0x00F +0x025 +0x010 +0x00E +0x00E +0x00F +0x025 +0x006
 +0x006 +0x025 +0x015 +0x013 +0x023 +0x009 +0x025 +0x015 +0x013 +0x013 +0x013 +0x014 +0x025 +0x015 +0x014 +0x025 +0x015 +0x013 +0x013 +0x013 +0x014 +0x025 +0x008 +0x022 +0x013 +0x014 +0x025 +0x006
 +0x006 +0x026 +0x025 +0x025 +0x008 +0x009 +0x025 +0x025 +0x025 +0x025 +0x025 +0x025 +0x025 +0x000 +0x000 +0x025 +0x025 +0x025 +0x025 +0x025 +0x025 +0x025 +0x008 +0x009 +0x025 +0x025 +0x026 +0x006
 +0x00D +0x00E +0x00F +0x025 +0x008 +0x009 +0x025 +0x010 +0x00F +0x025 +0x010 +0x00E +0x00E +0x00E +0x00E +0x00E +0x00E +0x00F +0x025 +0x010 +0x00F +0x025 +0x008 +0x009 +0x025 +0x010 +0x00E +0x011
 +0x012 +0x013 +0x014 +0x025 +0x015 +0x014 +0x025 +0x008 +0x009 +0x025 +0x015 +0x013 +0x013 +0x023 +0x022 +0x013 +0x013 +0x014 +0x025 +0x008 +0x009 +0x025 +0x015 +0x014 +0x025 +0x015 +0x013 +0x016
 +0x006 +0x025 +0x025 +0x025 +0x025 +0x025 +0x025 +0x008 +0x009 +0x025 +0x025 +0x025 +0x025 +0x008 +0x009 +0x025 +0x025 +0x025 +0x025 +0x008 +0x009 +0x025 +0x025 +0x025 +0x025 +0x025 +0x025 +0x006
 +0x006 +0x025 +0x010 +0x00E +0x00E +0x00E +0x00E +0x021 +0x024 +0x00E +0x00E +0x00F +0x025 +0x008 +0x009 +0x025 +0x010 +0x00E +0x00E +0x021 +0x024 +0x00E +0x00E +0x00E +0x00E +0x00F +0x025 +0x006
 +0x006 +0x025 +0x015 +0x013 +0x013 +0x013 +0x013 +0x013 +0x013 +0x013 +0x013 +0x014 +0x025 +0x015 +0x014 +0x025 +0x015 +0x013 +0x013 +0x013 +0x013 +0x013 +0x013 +0x013 +0x013 +0x014 +0x025 +0x006
 +0x006 +0x025 +0x025 +0x025 +0x025 +0x025 +0x025 +0x025 +0x025 +0x025 +0x025 +0x025 +0x025 +0x025 +0x025 +0x025 +0x025 +0x025 +0x025 +0x025 +0x025 +0x025 +0x025 +0x025 +0x025 +0x025 +0x025 +0x006
 +0x007 +0x002 +0x002 +0x002 +0x002 +0x002 +0x002 +0x002 +0x002 +0x002 +0x002 +0x002 +0x002 +0x002 +0x002 +0x002 +0x002 +0x002 +0x002 +0x002 +0x002 +0x002 +0x002 +0x002 +0x002 +0x002 +0x002 +0x00C