1  2  2  2  2  2  2  2  2  2  2  2  2  3  4  2  2  2  2  2  2  2  2  2  2  2  2  5
6  37 37 37 37 37 37 37 37 37 37 37 37 8  9  37 37 37 37 37 37 37 37 37 37 37 37 6
6  37 16 14 14 15 37 16 14 14 14 15 37 8  9  37 16 14 14 14 15 37 16 14 14 15 37 6
6  38 8  0  0  9  37 8  0  0  0  9  37 8  9  37 8  0  0  0  9  37 8  0  0  9  38 6
6  37 21 19 19 20 37 21 19 19 19 20 37 11 10 37 21 19 19 19 20 37 21 19 19 20 37 6
6  37 37 37 37 37 37 37 37 37 37 37 37 37 37 37 37 37 37 37 37 37 37 37 37 37 37 6
6  37 16 14 14 15 37 16 15 37 16 14 14 14 14 14 14 15 37 16 15 37 16 14 14 15 37 6
6  37 21 19 19 20 37 8  9  37 21 19 19 35 34 19 19 20 37 8  9  37 21 19 19 20 37 6
6  37 37 37 37 37 37 8  9  37 37 37 37 8  9  37 37 37 37 8  9  37 37 37 37 37 37 6
7  2  2  2  2  5  37 8  36 14 14 15 0  8  9  0  16 14 14 33 9  37 1  2  2  2  2  12
0  0  0  0  0  6  37 8  34 19 19 20 0  21 20 0  21 19 19 35 9  37 6  0  0  0  0  0
0  0  0  0  0  6  37 8  9  0  0  0  0  0  0  0  0  0  0  8  9  37 6  0  0  0  0  0
0  0  0  0  0  6  37 8  9  0  26 24 25 0  0  23 24 27 0  8  9  37 6  0  0  0  0  0
2  2  2  2  2  12 37 21 20 0  28 0  0  0  0  0  0  29 0  21 20 37 7  2  2  2  2  2
37 37 37 37 37 37 37 0  0  0  28 0  0  0  0  0  0  29 0  0  0  37 37 37 37 37 37 37
2  2  2  2  2  5  37 16 15 0  28 0  0  0  0  0  0  29 0  16 15 37 1  2  2  2  2  2
0  0  0  0  0  6  37 8  9  0  30 31 31 31 31 31 31 32 0  8  9  37 6  0  0  0  0  0
0  0  0  0  0  6  37 8  9  0  0  0  0  0  0  0  0  0  0  8  9  37 6  0  0  0  0  0
0  0  0  0  0  6  37 8  9  0  16 14 14 14 14 14 14 15 0  8  9  37 6  0  0  0  0  0
1  2  2  2  2  12 37 21 20 0  21 19 19 35 34 19 19 20 0  21 20 37 7  2  2  2  2  5
6  37 37 37 37 37 37 37 37 37 37 37 37 8  9  37 37 37 37 37 37 37 37 37 37 37 37 6
6  37 16 14 14 15 37 16 14 14 14 15 37 8  9  37 16 14 14 14 15 37 16 14 14 15 37 6
6  37 21 19 35 9  37 21 19 19 19 20 37 21 20 37 21 19 19 19 20 37 8  34 19 20 37 6
6  38 37 37 8  9  37 37 37 37 37 37 37 0  0  37 37 37 37 37 37 37 8  9  37 37 38 6
13 14 15 37 8  9  37 16 15 37 16 14 14 14 14 14 14 15 37 16 15 37 8  9  37 16 14 17
18 19 20 37 21 20 37 8  9  37 21 19 19 35 34 19 19 20 37 8  9  37 21 20 37 21 19 22
6  37 37 37 37 37 37 8  9  37 37 37 37 8  9  37 37 37 37 8  9  37 37 37 37 37 37 6
6  37 16 14 14 14 14 33 36 14 14 15 37 8  9  37 16 14 14 33 36 14 14 14 14 15 37 6
6  37 21 19 19 19 19 19 19 19 19 20 37 21 20 37 21 19 19 19 19 19 19 19 19 20 37 6
6  37 37 37 37 37 37 37 37 37 37 37 37 37 37 37 37 37 37 37 37 37 37 37 37 37 37 6
7  2  2  2  2  2  2  2  2  2  2  2  2  2  2  2  2  2  2  2  2  2  2  2  2  2  2  12