28 31

 0001 0002 0002 0002 0002 0002 0002 0002 0002 0002 0002 0002 0002 0003 0004 0002 0002 0002 0002 0002 0002 0002 0002 0002 0002 0002 0002 0005
 0006 -200 -200 -200 -200 -200 -200 -200 -200 -200 -200 -200 -200 0008 0009 -200 -200 -200 -200 -200 -200 -200 -200 -200 -200 -200 -200 0006
 0006 -200 0010 000E 000E 000F -200 0010 000E 000E 000E 000F -200 0008 0009 -200 0010 000E 000E 000E 000F -200 0010 000E 000E 000F -200 0006
 0006 -400 0008 0000 0000 0009 -200 0008 0000 0000 0000 0009 -200 0008 0009 -200 0008 0000 0000 0000 0009 -200 0008 0000 0000 0009 -400 0006
 0006 -200 0015 0013 0013 0014 -200 0015 0013 0013 0013 0014 -200 000B 000A -200 0015 0013 0013 0013 0014 -200 0015 0013 0013 0014 -200 0006
 0006 -200 -200 -200 -200 -200 -200 -200 -200 -200 -200 -200 -200 -200 -200 -200 -200 -200 -200 -200 -200 -200 -200 -200 -200 -200 -200 0006
 0006 -200 0010 000E 000E 000F -200 0010 000F -200 0010 000E 000E 000E 000E 000E 000E 000F -200 0010 000F -200 0010 000E 000E 000F -200 0006
 0006 -200 0015 0013 0013 0014 -200 0008 0009 -200 0015 0013 0013 0023 0022 0013 0013 0014 -200 0008 0009 -200 0015 0013 0013 0014 -200 0006
 0006 -200 -200 -200 -200 -200 -200 0008 0009 -200 -200 -200 -200 0008 0009 -200 -200 -200 -200 0008 0009 -200 -200 -200 -200 -200 -200 0006
 0007 0002 0002 0002 0002 0005 -200 0008 0024 000E 000E 000F 0000 0008 0009 0000 0010 000E 000E 0021 0009 -200 0001 0002 0002 0002 0002 000C
 0000 0000 0000 0000 0000 0006 -200 0008 0022 0013 0013 0014 0000 0015 0014 0000 0015 0013 0013 0023 0009 -200 0006 0000 0000 0000 0000 0000
 0000 0000 0000 0000 0000 0006 -200 0008 0009 0000 0000 0000 -008 -002 -004 -010 0000 0000 0000 0008 0009 -200 0006 0000 0000 0000 0000 0000
 0000 0000 0000 0000 0000 0006 -200 0008 0009 0000 001A 0018 0019 001F 001F 0017 0018 001B 0000 0008 0009 -200 0006 0000 0000 0000 0000 0000
 0002 0002 0002 0002 0002 000C -200 0015 0014 0000 001C 0000 0000 0000 0000 0000 0000 001D 0000 0015 0014 -200 0007 0002 0002 0002 0002 0002
 -200 -200 -200 -200 -200 -200 -200 0000 0000 0000 001C 0000 0000 0000 0000 0000 0000 001D 0000 0000 0000 -200 -200 -200 -200 -200 -200 -200
 0002 0002 0002 0002 0002 0005 -200 0010 000F 0000 001C 0000 0000 0000 0000 0000 0000 001D 0000 0010 000F -200 0001 0002 0002 0002 0002 0002
 0000 0000 0000 0000 0000 0006 -200 0008 0009 0000 001E 001F 001F 001F 001F 001F 001F 0020 0000 0008 0009 -200 0006 0000 0000 0000 0000 0000
 0000 0000 0000 0000 0000 0006 -200 0008 0009 0000 0000 0000 0000 0000 0000 0000 0000 0000 0000 0008 0009 -200 0006 0000 0000 0000 0000 0000
 0000 0000 0000 0000 0000 0006 -200 0008 0009 0000 0010 000E 000E 000E 000E 000E 000E 000F 0000 0008 0009 -200 0006 0000 0000 0000 0000 0000
 0001 0002 0002 0002 0002 000C -200 0015 0014 0000 0015 0013 0013 0023 0022 0013 0013 0014 0000 0015 0014 -200 0007 0002 0002 0002 0002 0005
 0006 -200 -200 -200 -200 -200 -200 -200 -200 -200 -200 -200 -200 0008 0009 -200 -200 -200 -200 -200 -200 -200 -200 -200 -200 -200 -200 0006
 0006 -200 0010 000E 000E 000F -200 0010 000E 000E 000E 000F -200 0008 0009 -200 0010 000E 000E 000E 000F -200 0010 000E 000E 000F -200 0006
 0006 -200 0015 0013 0023 0009 -200 0015 0013 0013 0013 0014 -200 0015 0014 -200 0015 0013 0013 0013 0014 -200 0008 0022 0013 0014 -200 0006
 0006 -400 -200 -200 0008 0009 -200 -200 -200 -200 -200 -200 -200 -001 0000 -200 -200 -200 -200 -200 -200 -200 0008 0009 -200 -200 -400 0006
 000D 000E 000F -200 0008 0009 -200 0010 000F -200 0010 000E 000E 000E 000E 000E 000E 000F -200 0010 000F -200 0008 0009 -200 0010 000E 0011
 0012 0013 0014 -200 0015 0014 -200 0008 0009 -200 0015 0013 0013 0023 0022 0013 0013 0014 -200 0008 0009 -200 0015 0014 -200 0015 0013 0016
 0006 -200 -200 -200 -200 -200 -200 0008 0009 -200 -200 -200 -200 0008 0009 -200 -200 -200 -200 0008 0009 -200 -200 -200 -200 -200 -200 0006
 0006 -200 0010 000E 000E 000E 000E 0021 0024 000E 000E 000F -200 0008 0009 -200 0010 000E 000E 0021 0024 000E 000E 000E 000E 000F -200 0006
 0006 -200 0015 0013 0013 0013 0013 0013 0013 0013 0013 0014 -200 0015 0014 -200 0015 0013 0013 0013 0013 0013 0013 0013 0013 0014 -200 0006
 0006 -200 -200 -200 -200 -200 -200 -200 -200 -200 -200 -200 -200 -200 -200 -200 -200 -200 -200 -200 -200 -200 -200 -200 -200 -200 -200 0006
 0007 0002 0002 0002 0002 0002 0002 0002 0002 0002 0002 0002 0002 0002 0002 0002 0002 0002 0002 0002 0002 0002 0002 0002 0002 0002 0002 000C