1  2  2  2  2  2  2  2  2  2  2  2  2  3  4  2  2  2  2  2  2  2  2  2  2  2  2  5 ,
6  0  0  0  0  0  0  0  0  0  0  0  0  8  9  0  0  0  0  0  0  0  0  0  0  0  0  6 ,
6  0  16 14 14 15 0  16 14 14 14 15 0  8  9  0  16 14 14 14 15 0  16 14 14 15 0  6 ,
6  0  8  0  0  9  0  8  0  0  0  9  0  8  9  0  8  0  0  0  9  0  8  0  0  9  0  6 ,
6  0  21 19 19 20 0  21 19 19 19 20 0  11 10 0  21 19 19 19 20 0  21 19 19 20 0  6 ,
6  0  0  0  0  0  0  0  0  0  0  0  0  0  0  0  0  0  0  0  0  0  0  0  0  0  0  6 ,
6  0  16 14 14 15 0  16 15 0  16 14 14 14 14 14 14 15 0  16 15 0  16 14 14 15 0  6 ,
6  0  21 19 19 20 0  8  9  0  21 19 19 35 34 19 19 20 0  8  9  0  21 19 19 20 0  6 ,
6  0  0  0  0  0  0  8  9  0  0  0  0  8  9  0  0  0  0  8  9  0  0  0  0  0  0  6 ,
7  2  2  2  2  5  0  8  36 14 14 15 0  8  9  0  16 14 14 33 9  0  1  2  2  2  2  12,
0  0  0  0  0  6  0  8  34 19 19 20 0  21 20 0  21 19 19 35 9  0  6  0  0  0  0  0 ,
0  0  0  0  0  6  0  8  9  0  0  0  0  0  0  0  0  0  0  8  9  0  6  0  0  0  0  0 ,
0  0  0  0  0  6  0  8  9  0  26 24 25 0  0  23 24 27 0  8  9  0  6  0  0  0  0  0 ,
2  2  2  2  2  12 0  21 20 0  28 0  0  0  0  0  0  29 0  21 20 0  7  2  2  2  2  2 ,
0  0  0  0  0  0  0  0  0  0  28 0  0  0  0  0  0  29 0  0  0  0  0  0  0  0  0  0 ,
2  2  2  2  2  5  0  16 15 0  28 0  0  0  0  0  0  29 0  16 15 0  1  2  2  2  2  2 ,
0  0  0  0  0  6  0  8  9  0  30 31 31 31 31 31 31 32 0  8  9  0  6  0  0  0  0  0 ,
0  0  0  0  0  6  0  8  9  0  0  0  0  0  0  0  0  0  0  8  9  0  6  0  0  0  0  0 ,
0  0  0  0  0  6  0  8  9  0  16 14 14 14 14 14 14 15 0  8  9  0  6  0  0  0  0  0 ,
1  2  2  2  2  12 0  21 20 0  21 19 19 35 34 19 19 20 0  21 20 0  7  2  2  2  2  5 ,
6  0  0  0  0  0  0  0  0  0  0  0  0  8  9  0  0  0  0  0  0  0  0  0  0  0  0  6 ,
6  0  16 14 14 15 0  16 14 14 14 15 0  8  9  0  16 14 14 14 15 0  16 14 14 15 0  6 ,
6  0  21 19 35 9  0  21 19 19 19 20 0  21 20 0  21 19 19 19 20 0  8  34 19 20 0  6 ,
6  0  0  0  8  9  0  0  0  0  0  0  0  0  0  0  0  0  0  0  0  0  8  9  0  0  0  6 ,
13 14 15 0  8  9  0  16 15 0  16 14 14 14 14 14 14 15 0  16 15 0  8  9  0  16 14 17,
18 19 20 0  21 20 0  8  9  0  21 19 19 35 34 19 19 20 0  8  9  0  21 20 0  21 19 22,
6  0  0  0  0  0  0  8  9  0  0  0  0  8  9  0  0  0  0  8  9  0  0  0  0  0  0  6 ,
6  0  16 14 14 14 14 33 36 14 14 15 0  8  9  0  16 14 14 33 36 14 14 14 14 15 0  6 ,
6  0  21 19 19 19 19 19 19 19 19 20 0  21 20 0  21 19 19 19 19 19 19 19 19 20 0  6 ,
6  0  0  0  0  0  0  0  0  0  0  0  0  0  0  0  0  0  0  0  0  0  0  0  0  0  0  6 ,
7  2  2  2  2  2  2  2  2  2  2  2  2  2  2  2  2  2  2  2  2  2  2  2  2  2  2  12,